0000000000000000000000000
0                       0
0                       0
0                       0
0       0000000         0
0                       0
0                       0
0                       0
0    00         00      0
0                       0
0                       0
0                       0
0                       0
0                       0
0                    0000
0                       0
0       20      53      0
0     p200     533      0
0     2000    5333      0
0000000000000000000333000
