xxxxxxxxxxxxxxxxxxxxxxxxx
x                       x
x                       x
x                       x
x       xxxxxxx         x
x                       x
x                       x
x                       x
x    xx         xx      x
x                       x
x                       x
x     xxxx              x
x                       x
x                       x
x                    xxxx
x                       x
x     xxxxxxxxxxx       x
x                       x
x  p                    x
xxxxxxxxxxxxxxxxxxxxxxxxx
