0000000000000000000000000000000000000000000000000000000000000
0                                                           0
0                                                           0
0                                                           0
0                                                           0
0                                                           0
0                                                           0
0                                                           0
0                                                           0
0                                                           0
0                                                           0
0                                                           0
0                                 200000000000000000000000000
0                                20                         0
0                               200                         0
0          2                   2000                         0
0             p               50000                         0
0      2000000001            500000                         0
0     200000000001          5000000                         0
0000000000000000000000000000000000000000000000000000000000000
