0000000000000000000000000000000000000000000000000000000000000
0                                                           0
0                                                           0
0                                                           0
0                                                           0
0                                                           0
0                                                           0
0                                                           0
0                                                           0
0                                             0000          0
0                                                           0
0                                                           0
0                                 200000000000000000000000000
0                                20                         0
0          01                   200                         0
0                              2000                         0
0                            p20000                         0
0      2000000001            200000                         0
0     200000000001          2000000                         0
0000000000000000000000000000000000000000000000000000000000000
